00000002000000000000000000000000
00000001000000000120000000000000
00000001000000000100000000000000
00000001000000001100000000000000
31120001100000011000011111100000
01000000100000010000140000111100
04000000100111110001100000001110
01000000114100000001100000000010
01000001100110000000100000000010
01100001000011000000100000000010
00111101000001000000100021100011
00000111000001000000100000110001
00000001100001114111100000010007
00000000100001000000000000010005
21000000130001100000000000010000
01100000111100111000000000010000
00110000000110002111111111140000
00011110000010000100000000010000
00000311111111111100000000010000
00000000000010000000000000010000
00000000021110000000000000010000
00000000000010000000000000010000
00000000000010000000000000030000
00000000000060000000000000000000